SO ./srcs/assets/s.xpm
NO ./srcs/assets/n.xpm


C 225,30,0

WE ./srcs/assets/o.xpm



EA ./srcs/assets/e.xpm

F 220,100,0
11111111
10100001
10100001
10100001
10000001
100N0101
10000001
11111111