11111111111111
10000000000001     1
10010W00000001
10000000000001111
11111111111111