11111111111111
10000000000001       1
100P0000000001
10000000000001111
11111111111111