SO ./srcs/assets/south.xpm
NO ./srcs/assets/north.xpm
WE ./srcs/assets/west.xpm
EA ./srcs/assets/east.xpm


C 75,0,130




F 140,140,140


1111111111111111111111111111111111
1000000000000000000110000000000001
1011000001110000000000000000000001
10010000000000000000000000000000S1
1111111110000000000100000000000001
1000000000000000000101111100000001
1111000000000000000000001000000001
1110000000010000000000001000111111
10000000000000000000000010001
10000000000000000000000010001
10000000000000000000000010001
1000101010101011111101111000111
1000111111111111 101111010001
11111111 1111111 111111111111
