SO ./srcs/assets/s.xpm
NO ./srcs/assets/n.xpm


C 140,140,140

WE ./srcs/assets/o.xpm



EA ./srcs/assets/e.xpm

F 140,140,140


1111111111111111111111111111111111
1000000000000000000110000000000001
1011000001110000000000000000000001
1001000000000000000000000000000011
111111111000000000010000000000001
1N0000000000001000010111110111111
11110000000001010000000010001
11100000000010100000000010001
11000000000000000000000010001
10000000000010100000000010001
10000000000000000000000010001
1010101010101011111101111000111
1111111111111111 101111010001
11111111 1111111 111111111111