SO ./srcs/assets/south.xpm
NO ./srcs/assets/north.xpm
WE ./srcs/assets/west.xpm
EA ./srcs/assets/east.xpm


C 75,0,130




F 140,140,140


1111111111111111111111111111111111
1000000000000000000110000000000001
1011000001110000000000000000000001
1001000000000000000000000000000011
111111111000000000010000000000001
100000000000000000010111110111111
11110000000000000000000010001
11100000000100000000000010001
1100000000000N000000000010001
10000000000000000000000010001
10000000000000000000000010001
1010101010101011111101111000111
1111111111111111 101111010001
11111111 1111111 111111111111

