11111111111111
100000E0000001
100P0000000001
100C0000000001
11111111111111