1111111111111111111111111111111111
1E0000000000000C00000C000000000001
101001010010000X10100100000X010101
1010000010101010000001000000010101
101001010000X0001010010X00000101X1
1010010010101010001001000000010101
1010010100100000101001X00110000101
10P000000000X00000000C000000010101
1111111111111111111111111111111111