NO ./ruta_a_la_textura_norte





SO ./ruta_a_la_textura_sur









WE ./ruta_a_la_textura_oeste






C 225,30,0










		 1111111111111111111111111
         1000000000110000000000001
         10110000011100000000000011
	     1001000000000000000000001            1
 111111111011000001110000000000001           101
 1000000000110000011101111111111111           1
 11110111111111011100000010001
 11110111111111011100000010001
 11110111111111011101W10010001
 11000000110101011100000010001
 100000000000000011000W0010001
 10000000100000001101010010001
 110000011101010111110111100111
 11110111 1110101 101111010001 
 11111111 1111111 111111111111










EA ./ruta_a_la_textura_este


F 220,100,0
