SO ./srcs/assets/south.xpm
NO ./srcs/assets/north.xpm
WE ./srcs/assets/west.xpm
EA ./srcs/assets/east.xpm
F 140,140,140
C 75,0,130
11111111111111111111
10000000000000000001
10000000000N00000001
10000000000000000001
11111111111111111111
